1100000
1100001
1100010
1100011
1100100
1100101
1100110
1100111
1101000
1101001
1101010
1101011
1101100
1101101
1101110
1101111
1010000
1010001
1010010
1010011
1010100
1010101
1010110
1010111
1011001
1011010
1011011
1011100
1011101
1011110
1011111